# Sprungli Lindt Vocab

fester Form herzustellen - to produce solid forms
die Schleckerei - yumminess 
rasch - suddenly
Zusparch - see below
verlagerte - to move something
Fachmann - specialist
angesehen - acknolwedged 
teilte - to split
erhielt - get
Nachfolgern - successor
zusprach - within the context of the text it's a legal term meaning to hand over. 
risikofreudige Unternehmer - risk-taking entreprenuer | der Unternehmer
erwerb - acquire/gain/purchase
der Schritt - step
die Anlagen - grounds/company buildings 
wohl berühmtester - most famous
das Verfahren - prcess
hoch überlegen war - was highly superior to ...
trug wesentlich zum ... bei - > beitragen - contributed | wesentlich - considerably
der Verwandten - relative
unvorstellbare Blütezeit - unimaginable heyday (Blüte - flowerbud/flowering)
kräftig Anteil - strong share
sämtlicher - all
die Einfuhrbeschränkung - import restrictions
der überstand - survived
lawinenartig - snowballing
verfügt - alloted
die Aktiengesellschaft - corporation/incorperated company
überwiegend - predominantly 
der kBesitz - wealth/holdings/assests/property
