wesen (s) - the essence
hilsberit - helpful
Auswärtige Dienst (r) - Diplomats
zittern - tremble
Auswärtiges Amt - Forgen Office/
Leidenshchaft - pasison
Zorn - ?
Vernunft

vor lauter Nachdenken 


eventuell - potentially
eventuell Rasismuss - potentially racsisim
Ausländerfeindlichkeit - xenophopbia
neuen leuten kennen lehrnen 
finanziell 
wenig Stebilität
Zeitverlust (z) - takes a lot of time
persönliche entfaltung - personal development
beruf - career
gelegenheit (
möglichkeit
göse Auswahl
anforderung (e) - demand, requirement

Fähigkeit - ability
Persönlichkeitsmerkmal - peronality attributes
Voraussetzung - assumption
rasch - brisk, efficient
Veränderung - change, about face
einzustellen - entaglemennt zone?? WTF?
Konjunkturflaute - economic lull
Fernpendler - long distance commute

alptraum		nightmare
anfang
angesehen - acknolwedged 
Augen			eyes
aus			from, but applied to a country
Ausbildung		qualification
ausdrucke		express (press out)
ausziechen - to change, to move out
bart			beard
Beruf			job
blŸt
dammerung		dawn/twilight
darf ich		may i
das Verfahren - prcess
den pzrenean		the pyranees
der kBesitz - wealth/holdings/assests/property
der Schritt - step
der Verwandten - relative
der überstand - survived
dick			thick
die Aktiengesellschaft - corporation/incorperated company
die Anlagen - grounds/company buildings 
die EinfuhrbeschrŠnkung - import restrictions
die Schleckerei - yumminess 
dunn			thin
durfte			allowed
entschieden 		decide
erhielt - get
erholen			relax
erkunden - explore
erlauben		usuallz/common
erwerb - acquire/gain/purchase
Fachmann - specialist
streichen - cancelled
fester Form herzustellen - to produce solid forms
fett			fat
Gewicht			weight
glatt/glatte		straight
greftic			muscley
Gršsse 			size
Harre			hair
Hindernissen - obsticles
hoch Ÿberlegen war - was highly superior to ...
kooken			to see
krŠftig Anteil - strong share
kurtze			short
überlaufen - overcrowded
verbringen - spend time somewhere
lange			long
lawinenartig - snowballing
lebndig			livlez
locken			curls
lockig			curly
machen - to dwell
man is ein glatzkopf	man is bald
manchmal
mittledreizig		middle thirties
muste			must
Nachfolgern - successor
neben			next to
oberlippen bart		moustache
rasch - suddenly
reiden/reidert
risikofreudige Unternehmer - risk-taking entreprenuer | der Unternehmer
schmall			small
sensible		sensitive
slank			thin
solte			should
steuer			tax
sŠmtlicher - all
teilte - to split
traum			dream
trug wesentlich zum ... bei - > beitragen - contributed | wesentlich - considerably
unvorstellbare BlŸtezeit - unimaginable heyday (BlŸte - flowerbud/flowering)
verfügt - alloted
verkhersgunstig - to do with location, lies next to a motorway!
verlagerte - to move something
von			from
wohl berŸhmtester - most famous
wšlte			wished
Zusparch - see below
zusprach - within the context of the text it's a legal term meaning to hand over. 
überwiegend - predominantly 



